11111111111111
1C11C0000000E1
1P00001C100011
11111111111111