1111111111111111111111111111111111
1E1100000000000C0000CCC00000000001
1000010100100000101001000000010101
1010010010101010001001000000010101
100000000C00C0000000000000000001C1
1C1100000000000C0000CCC00000000001
1000010100100000101001000000010101
1010010010101010001001000000010101
100C00000C00C0000000000000000001C1
101100000000000C0000CCC00000000001
1000010100100000101001000000010101
1010010010101010001001000000010101
100P00000C00C0000000000000000001C1
1111111111111111111111111111111111