11111
1E001
11C01
10P01
11111
11111