11111
1E101
11C11
10P01
10C01
11111